--X---------------EE-------X---------EE--o-oE-o-o-X-EX---X-o---E-------E-o---Xo--o----E-E---Xo-o-----------------------X-----o-E--EX-oo-----------oXo---E----o-XX------o------oX-----------Xo-------o---
---o--X-X------o----o---X----------o----Xo-E-EE-----o----E---E--E---EE----E---X-----E----X-E---E-----------------------o-o--EE---E-X---------------------Eo-o--X-------o-----o-E-o---------oE-----------
------E--X-------------------X-X---o---X--E--------X---------o-X-E---o-o----X---------E-X----X--o------------------E-X------EE---EoX--X--E----------E---oE--E--Xo---X-XE------EE-XX-----Eo-E----o---EX--
-BMX?--?------?----XX--XX-X-BB?X-MMMM-?X-?--MX-X-XM--M-MM-?-XMM-XX--X?-M??---XMM----XMX-----XX----BXMMB--X?---X---XM-B--X?MM?M?X-XB-M-M-XX-M-----X--XMXMX--MB-B--?XXXMX----MXX?M??M----M--M?---XX?-B-X?-
---o--------------X-E-----------------oE-------X--E--o----Xo---o-X-----o----XXXo----o--------o-X--------------X----E--------X-X--XE---o---------------------X---E-----E---o---E--E------------E----E----
---o----E-oXEo------o------E---E-------ooE--EX-oE-oo-----X---o--------------X----Xo------E-o-X-EE-----------E------E-X-----X---------------X-------E-----XX-E--E------E---E------X------E------------X--
------E-----------o-----E------o------Xo--o--o--E----X----o--X-------o-E--------------oEoE-XX--EE--EX---X-----X------o-E-E-E--E--EEX-Eo----o-------XE----E-EoE------o-------Xo---E-E--E-E----X----------
-XM-B-XX-?XMMXM?MXMB---XX--XXB---B-----X-BX----B-XMM-?X?-XXXM--M--X--M-?--X--BXM----XMXXMXB-XM---MBB--X-B--M--?XX-XMX-BXX-X------B--X?--BBX-MM--X---?-XX-XMXXX-?----BB??B-XM--?--X-XX-M--XBMXX?MMBM-M-Xv
---E----o-EooE---------------------o--------o-XX-----X----o--X------X----E----o-X--------X-E-----E----------o----------E----E-----o--E------------XX-----o-XoX------------X--oo--X-o---------o--EE-E---f
----------XoE--o---E---------o--------E-EE-----o-----o-----X----E--------X------X---X--------E-X-------------------------X---ooo---X--X-----------E-o--XXE-oo-------X-oo-------E-E-------E-E--X----o---f
------E-Eo-EX---X-oXE---E--E-----------XX---------Xo-----Xo----X--E--E---X-------EX-X-oEo---X---------------o------E-X--------E------o------------Xoo----o--X----X----o-E---XE---oEX----oX---EE----X---f
--TM?MXB--X---------BXXMBXM----X--BX?--B-X-BBBMX-XM?--X-X??BMMXXXX?---XX-M---X--XM-?B?--X?-MB-MX-MM??----XXXX--------BXX-??-?XMBBM--XB---X-?X??------X-X?----??B?---XM?X-X-MM-M-XXBBXM--B--MXM---BM-??Xf
--|--T-T---o------------o----------------------o--o-T------o-----o--X-----T---------o------X------------------E----o-----o--Eo-------o------------------oo--E-------E--E----oo-----------E---oE-----XT-f
--|--|-|--o--X-X--T-----X-------------oT---E---Eo---|----T-----XX--------E|---T-------o-----Eo------E---------E------o---E-oo-----T-----------------E----X---T---------X----o-----o-----X--EoXX-----X|-f
m-|--|-|--o-------|--------------------|--------X---|----|----------------|---|---o-o-E-X----o------o-------o--------E--o---EE-T-T---------------------------|--------------o----EoT----o----o--E---X|-X
XX|-X|-|-XX--XXX-X|---XXX-X-X-X--XX-X-X|-X---X-XX-X-|---X|--XX-XXXX--XX-XX|---|---XXX-X-X-X--X-----XXXXX---XXXXXXX--XX--X--XXX-|-|--XXXXX-X-X-X--X------XX---|---X---X-X----X---XXX|---XXX-X-XXXX---X|-X
